11111111111111111
10C11000000001001
10000C11011010001
1C010P0C01C000101
11110101110111001
100001C0E100C1C01
11111111111111111