11111111111111111
10C11X00000001001
10000C11011010001
1C010P0C01C0X0101
11110101110111001
1X0001C0E100C1C01
11111111111111111