1111111111
1P00000C01
1111111101
10000C0001
1011111111
1000000C01
1111111101
1000C00001
1011111111
100C000001
1111111101
100000C001
1011111111
10000C0001
1111111101
1E00000C01
1111111111